%%%%%%%%%%%%%%%%%%%%
%.   %        %    %
% %% % %%%%%% %%%%%%
% %              % %
% % %% %%  %% %% % %
%   .  %    %      %
% % %% %%%%%% %% % %
% %     .        %.%
% %% % %%%%%% %%%%%%
%  . %  .P    %   .%
%%%%%%%%%%%%%%%%%%%%
