%%%%%%%%%%%%%%%%%%%%
% .. %   .    % .  %
% %% % %%%%%% %% %%%
% %     .  .     % %
% % %% %.  %% %% % %
%     % .   %    . %
% % %% %.%%%% %% % %
% %    P.  .     % %
%%%%  . .  %%%%%%%%%
% . . ...        . %
%%%%%%%%%%%%%%%%%%%%
