%%%%%%%%%%%%%%%%%%%%
%    %     .  %    %
% %% % %%%%%% %% %%%
% % .            % %
% % %% %%  %% %% % %
%    .   %    %    %
% % %% %%%%%% %% % %
% %     .      . % %
% %% %.%%%%%% %%%%%%
%    %.P      %    %
%%%%%%%%%%%%%%%%%%%%
