%%%%%%%%%%%%%%%%%%%%
%    %    .   %    %
% %% % %%%%%% %% %%%
% %              % %
% % %% %%  %% %% % %
%      %    %      %
% % %% %%%%%% %% % %
% %              % %
% %% % %%%%%% %%%%%%
%    %   P    %   .%
%%%%%%%%%%%%%%%%%%%%
