%%%%%%%%%%%%%%%%%%%%%%%%%%%%%%%%%%%%
%       .         .               P%
% %%%%%%%%%%%%%%%%%%%%%%% %%%%%%%% %
% %%   %   %   .  %%%%%%% . %%     %
% %% % % % % %%%% %%%%%%%%% %% %%%%%
% %% % % % %    .  .     %% %%     %
% %% % % % % % %%%%  %%%    %%%%%% %
% %  % % %   %    %% %%%%%%%%   .  %
% %% % % %%%%%%%% %%        %% %%%%%
% %% %   %%   ..  %%%%%%%%% %%     %
%    %%%%%% %%%%%%%      %% %%%%%% %
%%%%%% .    %       %%%% %% %  .   %
%      %%%%%% %%%%% %    %% %% %%%%%
% %%%%%%   .  %       %%%%% %%     %
%        %%%%%% %%%%%%%%%%% %%  %% %
%%%%%%%%%%     .  .         %%%%%% %
%.         %%%%%%%%%%%%%%%%        %
%%%%%%%%%%%%%%%%%%%%%%%%%%%%%%%%%%%%