%%%%%%%%%%%%%%%%%%%%
%    %        %    %
% %% % %%%%%% %% %%%
% %              % %
% % %% %%  %% %% % %
%     %    %       %
% % %% %%%%%% %% % %
%.%              % %
%.%%.% %%%%%% %%%%%%
%        P    %   .%
%%%%%%%%%%%%%%%%%%%%
