%%%%%%%%%%%%%%%%%%%%
%    %        %    %
% %% % %%%%%% %% %%%
% %              % %
% % %% %%  %% %% % %
%     %    %    .  %
% % %% %%%%%% %% % %
% %    P         % %
%%%%%%%%%%%%%%%%%%%%
% . .              %
%%%%%%%%%%%%%%%%%%%%
