%%%%%%%%%%%%%%%%%%%%
%    %    .   %  . %
% %% % %%%%%% %% %%%
% %  .         . % %
% % %% %%  %% %% % %
%      %    %    . %
% % %% %%%%%% %% % %
% %  .           % %
% %% % %%%%%% %%%%%%
% .  %   P    %   .%
%%%%%%%%%%%%%%%%%%%%
