%%%%%%%%%
% P     % 
%%%%%%%%%  
%    .%%% 
%%%%%%%%%
