%%%%%%%%%%%%%%%%%%%%%%
% %%   .    % %      %
%    %%%%%% % %%%%%% %
%%%%%%     P  %      %
%    % %%%%%% %% %%%%%
% %%%% %         % . %
%  .     %%% %%%   % %
%%%%%%%%%%    %%%%%% %
%.         %%    .   %
%%%%%%%%%%%%%%%%%%%%%%