%%%%%%%%%%%%%%%%%%%%%%
%                    %
%                    %
%                    %
%         P          %
%                    %
%                    %
%                    %
%.                  .%
%%%%%%%%%%%%%%%%%%%%%%