%%%%%%%%%%%%%%%%%%%
%        P        %
%........ ........%
%%%%%%%%%%%%%%%%%%%